//MAP CONVERTED BY dmm2tgm.py THIS HEADER COMMENT PREVENTS RECONVERSION, DO NOT REMOVE
"a" = (
/turf/space/transit/east,
/area/space)
"b" = (
/obj/machinery/door/blast/shutters/indestructible{
	dir = 4;
	icon_state = "shutter1";
	id_tag = "_cargo_shuttle_doors"
	},
/obj/machinery/conveyor/indestructible{
	dir = 8;
	id_tag = "_cargo_shuttle_conveyors"
	},
/obj/machinery/button/blast_door/indestructible{
	dir = 8;
	icon_state = "blastctrl";
	id_tag = "_cargo_shuttle_doors";
	pixel_x = -8;
	pixel_y = 24
	},
/obj/structure/plasticflaps/airtight/indestructible,
/turf/simulated/floor/indestructible,
/area/shuttle/supply_shuttle)
"c" = (
/turf/simulated/wall/r_titanium/indestructible,
/area/shuttle/supply_shuttle)
"e" = (
/obj/machinery/conveyor/indestructible{
	dir = 8;
	id_tag = "_cargo_shuttle_conveyors"
	},
/obj/effect/floor_decal/industrial/outline/orange,
/turf/simulated/floor/indestructible,
/area/shuttle/supply_shuttle)
"f" = (
/turf/simulated/floor/indestructible,
/area/shuttle/supply_shuttle)
"g" = (
/obj/effect/floor_decal/industrial/outline/orange,
/obj/machinery/conveyor/indestructible{
	dir = 8;
	id_tag = "_cargo_shuttle_conveyors"
	},
/turf/simulated/floor/indestructible,
/area/shuttle/supply_shuttle)
"h" = (
/obj/machinery/door/airlock/hatch/indestructible{
	dir = 2;
	icon_state = "closed"
	},
/turf/simulated/floor/indestructible,
/area/shuttle/supply_shuttle)
"i" = (
/obj/effect/floor_decal/industrial/hatch/yellow,
/obj/structure/railing/mapped{
	dir = 8
	},
/turf/simulated/floor/indestructible,
/area/shuttle/supply_shuttle)
"j" = (
/obj/machinery/computer/shuttle_control/cargo,
/obj/machinery/embedded_controller/radio/simple_docking_controller/indestructible{
	dir = 8;
	id_tag = "cargo_bay";
	pixel_x = 20;
	pixel_y = 0;
	tag_door = "_cargo_shuttle_doors"
	},
/turf/simulated/floor/indestructible,
/area/shuttle/supply_shuttle)
"k" = (
/obj/abstract/level_data/transit_level/cargo_shuttle_standalone,
/turf/space/transit/east,
/area/space)
"l" = (
/obj/effect/floor_decal/industrial/outline/orange,
/obj/machinery/conveyor/indestructible{
	dir = 8;
	id_tag = "_cargo_shuttle_conveyors"
	},
/obj/effect/shuttle_landmark/supply/start,
/turf/simulated/floor/indestructible,
/area/shuttle/supply_shuttle)
"n" = (
/obj/structure/railing/mapped{
	dir = 8
	},
/turf/simulated/floor/indestructible,
/area/shuttle/supply_shuttle)
"p" = (
/obj/machinery/conveyor_switch/indestructible{
	id_tag = "_cargo_shuttle_conveyors"
	},
/obj/machinery/button/blast_door/indestructible{
	dir = 8;
	id_tag = "_cargo_shuttle_doors";
	pixel_x = 24;
	pixel_y = 0
	},
/turf/simulated/floor/indestructible,
/area/shuttle/supply_shuttle)
"q" = (
/obj/structure/shuttle/engine/propulsion/burst{
	dir = 8
	},
/turf/simulated/floor/airless/indestructible,
/area/shuttle/supply_shuttle)
"u" = (
/obj/structure/shuttle/engine/heater{
	dir = 4;
	icon_state = "heater";
	pixel_x = -8;
	pixel_y = 0
	},
/turf/simulated/floor/airless/indestructible,
/area/shuttle/supply_shuttle)
"w" = (
/obj/machinery/conveyor/indestructible{
	dir = 8;
	id_tag = "_cargo_shuttle_conveyors"
	},
/obj/effect/floor_decal/industrial/outline/orange,
/obj/structure/railing/mapped{
	icon_state = "railing_preview";
	dir = 1
	},
/turf/simulated/floor/indestructible,
/area/shuttle/supply_shuttle)
"x" = (
/obj/effect/floor_decal/industrial/outline/orange,
/obj/machinery/conveyor/indestructible{
	dir = 8;
	id_tag = "_cargo_shuttle_conveyors"
	},
/obj/structure/railing/mapped{
	icon_state = "railing_preview";
	dir = 1
	},
/turf/simulated/floor/indestructible,
/area/shuttle/supply_shuttle)
"z" = (
/turf/simulated/wall/r_titanium/indestructible,
/turf/space/transit/east,
/area/shuttle/supply_shuttle)
"F" = (
/obj/machinery/door/blast/shutters/indestructible{
	dir = 4;
	icon_state = "shutter1";
	id_tag = "_cargo_shuttle_doors"
	},
/obj/machinery/conveyor/indestructible{
	dir = 8;
	id_tag = "_cargo_shuttle_conveyors"
	},
/obj/structure/plasticflaps/airtight/indestructible,
/turf/simulated/floor/indestructible,
/area/shuttle/supply_shuttle)
"N" = (
/obj/machinery/conveyor/indestructible{
	dir = 8;
	id_tag = "_cargo_shuttle_conveyors"
	},
/obj/effect/floor_decal/industrial/outline/orange,
/obj/structure/railing/mapped,
/turf/simulated/floor/indestructible,
/area/shuttle/supply_shuttle)
"P" = (
/obj/effect/floor_decal/industrial/hatch/yellow,
/turf/simulated/floor/indestructible,
/area/shuttle/supply_shuttle)
"Q" = (
/obj/machinery/door/blast/shutters/indestructible{
	dir = 4;
	icon_state = "shutter1";
	id_tag = "_cargo_shuttle_doors"
	},
/obj/machinery/conveyor/indestructible{
	dir = 8;
	id_tag = "_cargo_shuttle_conveyors"
	},
/obj/machinery/conveyor_switch/indestructible{
	id_tag = "_cargo_shuttle_conveyors";
	pixel_x = -14;
	pixel_y = -24
	},
/obj/structure/plasticflaps/airtight/indestructible,
/turf/simulated/floor/indestructible,
/area/shuttle/supply_shuttle)
"S" = (
/obj/effect/floor_decal/industrial/outline/orange,
/obj/machinery/conveyor/indestructible{
	dir = 8;
	id_tag = "_cargo_shuttle_conveyors"
	},
/obj/structure/railing/mapped,
/turf/simulated/floor/indestructible,
/area/shuttle/supply_shuttle)

(1,1,1) = {"
a
a
a
a
a
a
a
a
a
a
k
"}
(2,1,1) = {"
a
a
q
c
b
F
Q
c
q
a
a
"}
(3,1,1) = {"
a
a
u
c
w
e
N
c
u
a
a
"}
(4,1,1) = {"
a
a
c
c
w
e
N
c
c
a
a
"}
(5,1,1) = {"
a
a
c
f
x
g
S
f
c
a
a
"}
(6,1,1) = {"
a
a
c
f
x
l
S
f
c
a
a
"}
(7,1,1) = {"
a
a
c
P
g
g
g
P
c
a
a
"}
(8,1,1) = {"
a
a
h
P
i
n
i
P
h
a
a
"}
(9,1,1) = {"
a
a
c
c
j
f
p
c
c
a
a
"}
(10,1,1) = {"
a
a
a
c
c
c
c
z
a
a
a
"}
(11,1,1) = {"
a
a
a
a
a
a
a
a
a
a
a
"}
